1
10
8
#########
# @     #
#   #####
# $  $  #
###$$## #
#  ..   #
#  .. ###
#########
