9
17
13
      #####
      #   #
   #### $ ####
   # $  $  $ #
####         ####
#      ...      #
# $   ..@..   $ #
#      ...      #
####         ####
   # $  $  $ #
   #### $ ####
      #   #
      #####
